1 10
14 43 31 0 1 1 31 0 24 0
0 0 0 0 1 0 1 0 0 -5
0 0 1 0 1 1 0 0 11 0
14 0 22 1 0 11 1 24 0 33
0 0 0 32 0 0 0 41 11 0
0 0 22 0 0 1 0 1 1 1
23 0 0 1 0 0 0 0 1 13
0 0 0 1 1 1 21 0 0 0
1 0 1 1 0 1 0 0 1 1
0 -1 0 11 0 0 0 41 33 0





6
0 0 -83 0 -82 -83
0 0 -82 0 1 -83
-1 0 -81 0 -84 0
0 0 -83 1 -81 0
0 -82 -83 -5 -81 -83
0 0 -84 0 -84 -84
