1 6
-1 0 0 0 0 1
0 1 0 1 0 1
0 0 0 0 0 0
1 0 0 1 0 0
0 1 55 0 0 1
0 0 0 1 0 -5

2 10
1 1 1 1 -1 0 1 1 1 1
0 0 1 0 0 0 0 1 0 0
-60 0 0 0 0 0 0 0 0 -61
0 0 1 0 0 0 0 1 0 0
1 1 1 0 0 0 0 1 1 1
1 1 1 1 1 60 1 1 1 1
55 0 0 0 0 0 0 0 0 0
1 1 1 1 61 1 1 1 1 1
0 0 0 0 0 0 0 0 0 0
-5 0 0 0 0 0 0 0 0 55

5 9
-5 0 -90 -91 0 1 1 1 1
-90 1 1 1 0 -90 0 1 1
-90 1 1 1 1 0 0 44 1
-90 0 0 0 -91 0 0 1 1
44 0 0 1 1 1 -91 1 1
1 1 0 1 0 -90 0 1 1
1 1 0 1 0 1 -90 1 1
1 1 0 1 0 1 -90 -91 -1
1 1 0 0 0 1 0 -91 -90

4 13
1 1 1 1 0 0 -1 0 0 1 1 1 1
55 55 55 1 0 0 0 0 0 1 55 55 55
1 1 60 1 0 0 0 0 0 1 61 1 1
-60 0 0 0 0 0 -65 0 0 0 0 0 -64
-62 0 0 0 0 0 -63 0 0 0 0 0 -61
1 1 62 1 0 0 0 0 0 1 63 1 1
55 55 55 1 0 0 0 0 0 1 55 55 55
1 1 1 1 0 0 0 0 0 1 1 1 1
0 0 0 0 0 0 0 0 0 0 0 0 0
1 1 1 1 1 1 64 1 1 1 1 1 1
0 0 0 0 0 0 0 0 0 0 0 0 -5
1 1 1 1 1 1 1 1 1 1 65 1 1
55 55 55 55 55 55 55 55 55 55 55 55 55

3 7
1 1 1 1 1 1 1
0 0 0 0 0 0 0
0 1 0 0 1 0 0
-1 1 0 0 1 57 -5
0 1 0 0 1 0 0
0 0 0 0 0 0 0
1 1 1 1 1 1 1

6 10
-1 0 1 0 1 0 1 0 1 57
0 0 0 0 0 0 0 0 0 0
0 1 0 1 0 1 0 1 0 1
0 0 0 0 0 0 0 0 0 0
1 0 1 0 1 0 1 0 1 0
0 0 0 0 0 0 0 0 0 0
0 1 0 1 0 1 0 1 0 1
0 0 0 0 0 0 0 0 0 0
1 0 1 0 1 0 1 0 1 0
57 0 0 0 0 0 0 0 0 -5

7 9
0 0 0 0 -1 0 0 0 0
0 1 0 0 1 0 0 1 0
0 0 1 1 1 1 1 0 0
12 0 0 0 1 0 0 0 24
1 33 0 0 1 0 0 21 1
-5 1 31 0 0 0 23 1 0
0 0 1 0 0 0 1 0 0
0 0 0 0 0 0 0 0 23
31 0 0 0 0 0 0 0 0

8 12
0 0 23 0 0 0 0 0 12 0 0 -1
0 0 0 0 0 0 0 0 0 0 0 0
1 0 0 0 0 0 0 12 0 0 0 0
0 0 0 44 0 0 0 0 0 0 0 0
0 0 0 0 0 0 0 0 0 0 0 1
0 32 0 0 0 1 0 0 0 0 0 0
0 0 0 0 0 0 0 0 1 1 0 0
0 0 0 0 0 0 0 0 0 0 0 0
0 0 -5 0 0 0 0 22 0 0 0 0
0 1 1 1 0 0 0 0 0 0 0 0
0 0 0 0 0 0 0 0 0 41 0 0
0 0 0 0 0 0 0 1 0 0 0 33

9 7
57 0 0 -5 0 0 57
0 0 0 0 0 0 0
0 0 0 0 0 0 0
0 1 0 1 0 1 0
0 0 0 0 0 0 0
0 0 0 0 0 0 0
57 0 0 -1 0 0 57

10 7
0 0 0 -1 0 0 0
33 -90 -91 0 -90 -91 42
1 -61 -91 0 -90 -60 1
55 1 1 60 1 1 55
61 0 0 0 0 0 62
-62 0 1 63 1 0 -63
1 1 1 -5 1 1 1
