1 4
-1 41 1 0
1 1 0 1
0 1 -5 1
24 13 0 0



8
-1 1 1 1 1 1 1 1
0 1 1 1 1 1 1 1
0 1 1 1 1 1 1 1
0 1 1 1 1 1 1 1
0 1 13 14 11 12 1 1
0 0 0 0 0 0 -5 1
1 1 1 1 1 1 1 1
1 1 1 1 1 1 1 1