1 11
0 1 -1 0 0 0 1 0 0 1 0
0 11 0 1 0 0 1 0 0 14 12
-5 1 0 0 1 0 1 0 12 1 0
0 0 1 0 0 0 1 1 0 1 1
23 0 0 0 0 1 0 34 31 1 0
0 22 0 0 0 1 21 1 1 1 0
43 0 0 0 42 0 1 0 0 1 1
0 13 0 1 1 13 0 13 0 1 22
0 31 -90 1 0 1 0 43 32 0 0
41 0 0 0 12 0 0 0 0 1 11
0 0 0 -91 24 1 0 1 12 0 0



1 8
-1 0 0 0 0 1 0 0
0 0 0 0 0 12 0 1
1 1 0 0 0 0 0 1
1 0 0 1 0 0 0 0
1 0 13 1 1 0 1 0
0 0 0 0 0 0 0 0
0 1 0 1 14 0 0 1
0 1 0 0 0 0 0 -5

2 8
-1 1 0 0 0 0 0 0
0 1 1 0 0 0 0 1
0 0 0 0 12 0 0 1
0 0 0 0 0 0 0 0
0 11 0 0 0 13 0 0
1 0 0 0 14 0 0 0
0 0 0 12 0 0 0 1
11 0 0 0 0 0 0 -5

3 8
0 0 1 -1 0 1 0 0
0 0 0 0 0 0 0 0
0 0 21 0 0 11 0 0
0 22 0 0 0 0 12 0
23 0 0 0 0 0 0 13
0 24 0 0 0 0 14 0
0 0 21 0 0 11 0 0
0 0 0 0 -5 0 0 0

4 9
-1 0 0 0 0 0 0 0 0
0 14 0 0 14 0 0 0 0
0 0 0 13 0 0 0 0 0
0 0 0 0 -5 0 0 0 0
0 0 0 0 1 0 0 0 0
0 0 0 0 0 0 0 12 0
0 0 0 0 0 0 0 0 0
0 0 0 0 0 13 0 0 0
0 0 0 0 0 0 0 0 0

5 7
0 0 0 0 0 33 0
23 0 0 0 0 0 0
0 0 0 1 41 0 0
0 -1 1 1 1 -5 0
0 31 0 1 0 0 44
0 0 0 12 0 0 0
0 0 0 0 0 21 0