1 8
-1 0 0 1 1 0 0 0
0 11 0 0 0 0 11 0
0 0 0 0 0 0 0 0
1 0 0 1 0 1 0 1
1 0 0 0 13 0 0 1
0 0 0 0 0 0 0 0
0 14 0 0 0 0 11 0
0 0 0 1 1 0 0 -5

2 8
-1 0 1 0 0 0 0 0
0 0 0 13 0 1 0 0
1 0 0 0 0 0 0 0
0 0 0 0 0 0 0 0
0 0 0 1 0 0 14 0
0 0 0 0 0 0 0 0
0 0 11 0 0 0 0 1
12 0 0 0 0 0 0 -5

3 8
-1 1 1 1 1 1 1 1
0 1 1 1 1 1 1 1
0 1 11 1 13 1 14 1
0 0 0 0 0 0 0 0
0 0 0 0 0 0 0 0
1 1 1 12 1 12 1 0
1 1 1 1 1 1 1 0
1 1 1 1 1 1 1 -5

4 8
-1 1 0 0 0 0 0 0
0 11 0 0 0 0 0 0
0 0 13 0 0 0 0 0
0 0 0 0 0 0 0 0
0 0 0 0 14 0 0 0
0 0 0 0 0 12 0 0
0 0 0 0 0 0 12 0
0 0 0 0 0 0 1 -5

5 8
-1 0 0 0 1 0 0 14
0 0 0 0 0 0 0 0
0 0 0 0 1 0 1 0
0 0 13 0 0 0 1 0
0 0 0 0 0 0 1 0
0 1 0 0 0 12 1 0
0 0 0 0 0 0 1 0
12 0 0 12 0 0 0 -5

6 8
-1 0 1 1 1 1 1 1
0 0 0 1 1 1 1 1
0 0 0 0 1 1 1 1
1 0 0 0 0 1 1 1
1 1 0 0 0 0 1 1
11 0 0 0 0 0 0 1
0 0 0 0 0 0 0 0
1 1 13 14 12 12 1 -5

7 8
-1 0 1 0 0 11 0 11
1 0 1 0 1 0 0 0
1 0 0 13 0 0 1 0
0 0 0 0 0 1 0 0
0 1 1 0 0 0 1 0
0 0 0 0 1 0 0 0
0 0 1 0 0 0 1 0
12 0 0 0 0 14 1 -5

8 8
-1 0 1 13 0 0 0 0
1 0 0 0 0 1 0 0
0 0 1 0 0 0 0 0
11 0 0 1 0 0 1 0
0 0 0 14 0 0 0 0
0 0 0 0 0 0 0 12
0 1 0 0 0 1 0 1
0 0 0 0 12 0 0 -5

9 8
-1 0 0 0 0 0 0 0
1 1 1 1 0 1 1 0
1 0 0 0 0 0 0 0
1 0 1 0 0 0 1 13
0 0 0 0 32 0 0 0
1 0 0 0 0 0 0 1
0 0 34 1 0 1 1 0
0 0 0 0 0 0 0 -5

10 8
0 14 24 11 24 13 21 0
41 -1 0 0 0 0 0 33
14 0 0 0 0 0 0 12
22 0 0 0 0 0 0 24
-90 0 0 0 0 0 0 -91
-91 0 0 0 0 0 0 -90
34 0 0 0 0 0 -5 42
0 21 13 24 14 21 12 0