1 8 8
0 0 0 1 0 0 1 0
0 1 0 -1 0 1 1 0
0 0 0 0 0 0 0 0
0 1 1 -90 1 1 1 0
0 0 1 0 0 0 0 0
0 0 0 1 0 1 0 0
0 1 0 0 -5 0 0 1
0 0 0 1 0 0 1 0

2 9 12
-90 0 0 0 -1 0 -90 0 0
0 1 -91 0 0 0 0 1 0
0 0 1 -90 0 1 0 0 0
-90 0 0 0 -90 0 0 1 0
0 0 1 -91 0 1 0 -91 0
-91 0 0 0 0 -90 0 0 1
-90 0 0 1 0 0 1 0 0
0 1 0 0 -90 0 0 -91 0
-5 0 -91 0 0 -91 1 0 0


6 8 7
-1 0 0 0 0 0 0 0
0 -80 -80 -80 -80 -80 -80 0
0 -80 -80 -80 -80 -80 -80 0
0 -80 -80 -80 -80 -80 -80 0
0 -80 -80 -80 -80 -80 -80 0
0 -80 -80 -80 -80 -80 -80 0
0 -80 -80 -80 -80 -80 -80 0
0 0 0 0 0 0 0 -5